.......U.Y.....
...........L.L.
...............
......R..G..O..
...RD.....O....
...........N.B.
...DF..W.......
....W.C..CF....
M......Y.......
.GU...........S
....B.....N....
............T..
..........S.M..
.T.............
...............