N..P...........
BO.......LF..T.
....F.S......R.
..........GT...
..N..D.YW......
..U.L.........S
...............
...U....C......
...............
...M.D.........
......M..CY....
...............
......O.....P..
W.....B........
........GR.....