N.....R........
............CO.
............O.C
..G...D.......B
............N..
...........S...
.P....T........
....B..FM......
.....Y.........
..B...L...D....
......GW..M..R.
...L.Y.........
.........W.....
.......P...F...
........T....SB