...............
.GRU...U.N.....
.........O...O.
.....RSB...C...
...S....T......
......F........
........G......
......W........
..........Y....
.Y...D..D..T...
........WL.....
...........C...
..L.........P..
....B..M.......
.......N.......